Nombre.de.Comunidad,Código.de.Provincia,Nombre.de.Provincia,Población,Total.censo.electoral,Total.votantes,Votos.válidos,Votos.a.candidaturas,Votos.en.blanco,Votos.nulos,siglas,votos,sobrevalido,swingfactor_abs,swingfactor
Andalucía,4,Almería,701211,491496,308989,306674,304461,2213,2315,PP,131801,42.977559232279226,1.1077851234609697,1.3019557477212733
Andalucía,11,Cádiz,1240284,993689,622252,615755,608817,6938,6497,PP,198876,32.297910695000446,1.115143277818196,0.9784280731596622
Andalucía,14,Córdoba,795611,651184,452038,446818,442329,4489,5220,PP,153750,34.40998348320793,0.91235500030757255,1.0424108901305038
Andalucía,18,Granada,917297,748579,494171,489540,486116,3424,4631,PP,172721,35.28230583813376,1.0138859719771813,1.0688368930061727
Andalucía,21,Huelva,520017,396117,249269,245819,243293,2526,3450,PP,81959,33.34119819867463,1.1059628648205073,1.0100332686663023
Andalucía,23,Jaén,654170,532211,375082,370762,368217,2545,4320,PP,131234,35.39575253127343,0.88078212057665906,1.0722736301506643
Andalucía,29,Málaga,1628973,1163657,752086,744858,738680,6178,7228,PP,256033,34.373397345534315,1.0551538057793985,1.0413025551509942
Andalucía,41,Sevilla,1941480,1531806,1044851,1033112,1023530,9582,11739,PP,299884,29.02724970767932,0.9483770879627175,0.8793471586694735
Aragón,22,Huesca,222909,173546,118018,116884,115680,1204,1134,PP,42332,36.217104137435406,0.95453841968319,1.0971555327911362
Aragón,44,Teruel,138932,109380,75932,74922,74218,704,1010,PP,30913,41.260243987079896,0.9122801505207698,1.2499316566822145
Aragón,50,Zaragoza,956006,734064,517144,513135,509011,4124,4009,PP,179211,34.92472741091526,0.8815798597753839,1.0580044656442067
Principado de Asturias,33,Asturias,1051229,982837,600463,594699,589325,5374,5764,PP,209632,35.25010131175603,1.1606541982188268,1.0678612939035454
Illes Balears,7,Illes Balears,1104479,772939,469437,464787,460561,4226,4650,PP,163045,35.07950953877798,1.171419168730247,1.0626934122622835
Canarias,35,Las Palmas,1098406,842916,508957,502506,499004,3502,6451,PP,170316,33.893326646846006,1.1819656201767403,1.0267593652482887
Canarias,38,Santa Cruz de Tenerife,1001900,833373,481925,476666,473883,2783,5259,PP,163129,34.22291499708391,1.2581071785374423,1.036743865406965
Cantabria,39,Cantabria,585179,498203,341348,337567,335113,2454,3781,PP,140252,41.547900120568656,0.9392647389515052,1.2586458685419164
Castilla - La Mancha,2,Albacete,394580,310083,221706,219473,218043,1430,2233,PP,89717,40.87837683906449,0.8502708455678165,1.2383634304472733
Castilla - La Mancha,13,Ciudad Real,513713,400552,282634,279396,277457,1939,3238,PP,121622,43.53032971123423,0.8782480415689832,1.318701293887738
Castilla - La Mancha,16,Cuenca,203841,157835,117118,115849,115026,823,1269,PP,53004,45.752660791202345,0.7696060045183283,1.3860242590488443
Castilla - La Mancha,19,Guadalajara,253686,182408,132903,131538,130716,822,1365,PP,52047,39.568033572047625,0.8096571833145115,1.198668087611258
Castilla - La Mancha,45,Toledo,693371,518206,371866,367503,365529,1974,4363,PP,159521,43.40672048935655,0.842474187866627,1.314956694618496
Castilla y León,5,Ávila,164925,139218,100106,98917,98200,717,1189,PP,50931,51.48862177381036,0.8381285291099745,1.559788602660114
Castilla y León,9,Burgos,364002,300243,209246,206981,205169,1812,2265,PP,88785,42.89524159222344,0.9041701679078291,1.2994620294523915
Castilla y León,24,León,479395,440263,284076,280858,278461,2397,3218,PP,112723,40.135228478448184,1.0583484659042242,1.2158506052241196
Castilla y León,34,Palencia,166035,143769,101838,100626,99788,838,1212,PP,45965,45.67904915230656,0.8700935674605698,1.3837942790762363
Castilla y León,37,Salamanca,339395,308612,204615,202483,201040,1443,2132,PP,97672,48.23713595709269,1.0053192356495122,1.4612885779185911
Castilla y León,40,Segovia,157570,120823,89662,88525,87910,615,1137,PP,40172,45.37927139226207,0.7694098847172584,1.3747128564756763
Castilla y León,42,Soria,91006,76814,50337,49618,49018,600,719,PP,22264,44.87081301140715,1.0283107699701468,1.3593096943776781
Castilla y León,47,Valladolid,526288,433056,319280,315768,313534,2234,3512,PP,132026,41.81107648653442,0.7837951850043215,1.2666184939877134
Castilla y León,49,Zamora,183436,173320,110339,108893,107883,1010,1446,PP,52555,48.262973744868816,1.0840688406176278,1.4620713039948143
Cataluña,8,Barcelona,5523922,4131319,2659818,2643933,2622852,21081,15885,PP,357759,13.531318683189022,1.0625951302898626,0.4099157432047568
Cataluña,17,Girona,753054,512366,310377,307853,305211,2642,2524,PP,31035,10.081110140229265,1.1760977155007135,0.3053956419336342
Cataluña,25,Lleida,436029,313207,182909,181159,179003,2156,1750,PP,24503,13.52568737959472,1.2410871524930254,0.40974514933640477
Cataluña,43,Tarragona,795101,562990,347861,344620,341560,3060,3241,PP,51241,14.868841042307468,1.139972218737824,0.4504344453895022
Extremadura,6,Badajoz,686730,558228,382981,377949,375230,2719,5032,PP,149603,39.582853771276014,0.9365586208921605,1.199117048508816
Extremadura,10,Cáceres,406267,349082,239735,236205,234666,1539,3530,PP,95419,40.39668931648357,0.9344916107886598,1.2237712607235254
Galicia,15,A Coruña,1127196,1087472,651065,643389,636696,6693,7676,PP,257855,40.0776202266436,1.1972080117288424,1.21410542946512
Galicia,27,Lugo,339386,348561,196272,192957,190869,2088,3315,PP,91516,47.428183481293765,1.3034240559407635,1.4367822926777876
Galicia,32,Ourense,318391,364469,188562,186177,184650,1527,2385,PP,92539,49.704850760297994,1.4398541976695018,1.5057513105209936
Galicia,36,Pontevedra,947374,901233,551762,544673,540255,4418,7089,PP,208921,38.35714272600257,1.1568313436579687,1.1619855415329468
Comunidad de Madrid,28,Madrid,6436996,4927932,3489376,3465795,3447658,18137,23581,PP,1325665,38.24995419521351,0.8708794774093342,1.1587383882221605
Comunidad Foral de Navarra,31,Navarra,640476,502530,338720,335335,331867,3468,3385,PP,106976,31.90123309526295,0.9724659571019328,0.9664111813166602
País Vasco,1,Araba - Álava,323648,254579,169331,167640,166562,1078,1691,PP,34276,20.446194225721783,0.9989818840878956,0.6193939480679123
País Vasco,20,Gipuzkoa,716834,580706,367464,365493,362782,2711,1971,PP,35312,9.661470944723975,1.0955001058829656,0.29268315494468267
País Vasco,48,Bizkaia,1148775,948080,625444,621219,617312,3907,4225,PP,78965,12.711298270014279,1.0152285669577845,0.385074167525425
Región de Murcia,30,Murcia,1467288,1034075,719536,713592,709879,3713,5944,PP,333109,46.68059619502461,0.9074411158162694,1.414134995305199
La Rioja,26,La Rioja,317053,247670,174913,172982,171757,1225,1931,PP,73708,42.61021377946839,0.8763899110111971,1.290827439547664
Comunitat Valenciana,3,Alicante / Alacant,1855047,1253296,882601,875169,870331,4838,7432,PP,329628,37.66449680004662,0.882386925972212,1.1410026295076225
Comunitat Valenciana,12,Castellón / Castelló,582327,416491,302324,299204,297135,2069,3120,PP,106746,35.6766620767102,0.8177695926626533,1.0807834618815573
Comunitat Valenciana,46,Valencia / València,2543315,1946046,1431843,1419521,1411013,8508,12322,PP,482855,34.01534743057694,0.7882745302115405,1.0304558446100254
Ciudad de Ceuta,51,Ceuta,84263,61587,31194,30837,30521,316,357,PP,15991,51.85653597950514,1.4722464326906544,1.5709341405484745
Ciudad de Melilla,52,Melilla,85584,57795,27483,27121,26853,268,362,PP,13522,49.85804358246377,1.564661203773274,1.5103921109501295
Andalucía,4,Almería,701211,491496,308989,306674,304461,2213,2315,PSOE,84988,27.7128155631061,1.1077851234609697,1.224605195011317
Andalucía,11,Cádiz,1240284,993689,622252,615755,608817,6938,6497,PSOE,175498,28.50127079763867,1.115143277818196,1.2594463454546474
Andalucía,14,Córdoba,795611,651184,452038,446818,442329,4489,5220,PSOE,139281,31.171752257071113,0.91235500030757255,1.377452596423823
Andalucía,18,Granada,917297,748579,494171,489540,486116,3424,4631,PSOE,151445,30.936184989990608,1.0138859719771813,1.367043083958931
Andalucía,21,Huelva,520017,396117,249269,245819,243293,2526,3450,PSOE,88100,35.83937775355038,1.1059628648205073,1.583710903824586
Andalucía,23,Jaén,654170,532211,375082,370762,368217,2545,4320,PSOE,138612,37.385708351988605,0.88078212057665906,1.6520419068488117
Andalucía,29,Málaga,1628973,1163657,752086,744858,738680,6178,7228,PSOE,201444,27.044617900324624,1.0551538057793985,1.1950781219763422
Andalucía,41,Sevilla,1941480,1531806,1044851,1033112,1023530,9582,11739,PSOE,347470,33.63333307521353,0.9483770879627175,1.4862277099078007
Aragón,22,Huesca,222909,173546,118018,116884,115680,1204,1134,PSOE,29915,25.593751069436365,0.95453841968319,1.1309655797364722
Aragón,44,Teruel,138932,109380,75932,74922,74218,704,1010,PSOE,19724,26.326045754251087,0.9122801505207698,1.1633250443769814
Aragón,50,Zaragoza,956006,734064,517144,513135,509011,4124,4009,PSOE,125321,24.422617829615987,0.8815798597753839,1.0792142213705695
Principado de Asturias,33,Asturias,1051229,982837,600463,594699,589325,5374,5764,PSOE,147920,24.873087057486224,1.1606541982188268,1.0991200644050474
Illes Balears,7,Illes Balears,1104479,772939,469437,464787,460561,4226,4650,PSOE,93363,20.087265779808817,1.171419168730247,0.8876387883256216
Canarias,35,Las Palmas,1098406,842916,508957,502506,499004,3502,6451,PSOE,119351,23.751159190139024,1.1819656201767403,1.049543048614186
Canarias,38,Santa Cruz de Tenerife,1001900,833373,481925,476666,473883,2783,5259,PSOE,101120,21.21401568393802,1.2581071785374423,0.9374288857241724
Cantabria,39,Cantabria,585179,498203,341348,337567,335113,2454,3781,PSOE,79407,23.523330183341383,0.9392647389515052,1.039475483134838
Castilla - La Mancha,2,Albacete,394580,310083,221706,219473,218043,1430,2233,PSOE,59617,27.163705786133146,0.8502708455678165,1.2003405119811377
Castilla - La Mancha,13,Ciudad Real,513713,400552,282634,279396,277457,1939,3238,PSOE,81728,29.25167146272674,0.8782480415689832,1.292605897601712
Castilla - La Mancha,16,Cuenca,203841,157835,117118,115849,115026,823,1269,PSOE,34426,29.716268591010714,0.7696060045183283,1.3131360402567704
Castilla - La Mancha,19,Guadalajara,253686,182408,132903,131538,130716,822,1365,PSOE,30282,23.021484285909775,0.8096571833145115,1.017299349797162
Castilla - La Mancha,45,Toledo,693371,518206,371866,367503,365529,1974,4363,PSOE,97733,26.593796513225744,0.842474187866627,1.1751567173321142
Castilla y León,5,Ávila,164925,139218,100106,98917,98200,717,1189,PSOE,19277,19.48805564260946,0.8381285291099745,0.8611602139906964
Castilla y León,9,Burgos,364002,300243,209246,206981,205169,1812,2265,PSOE,45724,22.090916557558423,0.9041701679078291,0.976178371964579
Castilla y León,24,León,479395,440263,284076,280858,278461,2397,3218,PSOE,73681,26.234253608585124,1.0583484659042242,1.1592688293674382
Castilla y León,34,Palencia,166035,143769,101838,100626,99788,838,1212,PSOE,24751,24.59702263828434,0.8700935674605698,1.0869210180417297
Castilla y León,37,Salamanca,339395,308612,204615,202483,201040,1443,2132,PSOE,43252,21.36080559849469,1.0053192356495122,0.9439154042640163
Castilla y León,40,Segovia,157570,120823,89662,88525,87910,615,1137,PSOE,19014,21.47867833945213,0.7694098847172584,0.9491240980756576
Castilla y León,42,Soria,91006,76814,50337,49618,49018,600,719,PSOE,12762,25.720504655568543,1.0283107699701468,1.1365667103653798
Castilla y León,47,Valladolid,526288,433056,319280,315768,313534,2234,3512,PSOE,71780,22.73187910111221,0.7837951850043215,1.0045019487897575
Castilla y León,49,Zamora,183436,173320,110339,108893,107883,1010,1446,PSOE,26045,23.91797452545159,1.0840688406176278,1.0569144730645865
Cataluña,8,Barcelona,5523922,4131319,2659818,2643933,2622852,21081,15885,PSOE,444812,16.823875642839663,1.0625951302898626,0.7434324190384297
Cataluña,17,Girona,753054,512366,310377,307853,305211,2642,2524,PSOE,38558,12.524808918542291,1.1760977155007135,0.553460402940446
Cataluña,25,Lleida,436029,313207,182909,181159,179003,2156,1750,PSOE,22533,12.438244856728067,1.2410871524930254,0.5496352124051289
Cataluña,43,Tarragona,795101,562990,347861,344620,341560,3060,3241,PSOE,53967,15.6598572340549,1.139972218737824,0.6919954588623465
Extremadura,6,Badajoz,686730,558228,382981,377949,375230,2719,5032,PSOE,133392,35.293650730654136,0.9365586208921605,1.559595701752282
Extremadura,10,Cáceres,406267,349082,239735,236205,234666,1539,3530,PSOE,78767,33.34688088736479,0.9344916107886598,1.4735696370907994
Galicia,15,A Coruña,1127196,1087472,651065,643389,636696,6693,7676,PSOE,139973,21.755578662364446,1.1972080117288424,0.9613600822962637
Galicia,27,Lugo,339386,348561,196272,192957,190869,2088,3315,PSOE,45796,23.733785247490374,1.3034240559407635,1.048775309213008
Galicia,32,Ourense,318391,364469,188562,186177,184650,1527,2385,PSOE,43429,23.326726717048828,1.4398541976695018,1.0307877471077698
Galicia,36,Pontevedra,947374,901233,551762,544673,540255,4418,7089,PSOE,118816,21.814189431089847,1.1568313436579687,0.9639500411440498
Comunidad de Madrid,28,Madrid,6436996,4927932,3489376,3465795,3447658,18137,23581,PSOE,678340,19.572421334787546,0.8708794774093342,0.8648882604855301
Comunidad Foral de Navarra,31,Navarra,640476,502530,338720,335335,331867,3468,3385,PSOE,58173,17.347726899965707,0.9724659571019328,0.7665809500647683
País Vasco,1,Araba - Álava,323648,254579,169331,167640,166562,1078,1691,PSOE,26381,15.736697685516582,0.9989818840878956,0.6953909715208388
País Vasco,20,Gipuzkoa,716834,580706,367464,365493,362782,2711,1971,PSOE,51449,14.07660338228092,1.0955001058829656,0.6220328494158603
País Vasco,48,Bizkaia,1148775,948080,625444,621219,617312,3907,4225,PSOE,86425,13.912163021414347,1.0152285669577845,0.6147663730187516
Región de Murcia,30,Murcia,1467288,1034075,719536,713592,709879,3713,5944,PSOE,144937,20.310905951860448,0.9074411158162694,0.8975212528440322
La Rioja,26,La Rioja,317053,247670,174913,172982,171757,1225,1931,PSOE,42010,24.285763836699772,0.8763899110111971,1.0731667625585406
Comunitat Valenciana,3,Alicante / Alacant,1855047,1253296,882601,875169,870331,4838,7432,PSOE,187484,21.422605233960525,0.882386925972212,0.9466462763570714
Comunitat Valenciana,12,Castellón / Castelló,582327,416491,302324,299204,297135,2069,3120,PSOE,66062,22.07925027740271,0.8177695926626533,0.9756628492002966
Comunitat Valenciana,46,Valencia / València,2543315,1946046,1431843,1419521,1411013,8508,12322,PSOE,285732,20.128761744278528,0.7882745302115405,0.8894724588722284
Ciudad de Ceuta,51,Ceuta,84263,61587,31194,30837,30521,316,357,PSOE,6974,22.61568894509842,1.4722464326906544,0.9993676069420424
Ciudad de Melilla,52,Melilla,85584,57795,27483,27121,26853,268,362,PSOE,6805,25.091257696987572,1.564661203773274,1.1087608350414306
Andalucía,4,Almería,701211,491496,308989,306674,304461,2213,2315,C's,41897,13.661738523643999,1.1077851234609697,1.0460749252407349
Andalucía,11,Cádiz,1240284,993689,622252,615755,608817,6938,6497,C's,88029,14.296108029979457,1.115143277818196,1.094648394332271
Andalucía,14,Córdoba,795611,651184,452038,446818,442329,4489,5220,C's,55248,12.36476596735136,0.91235500030757255,0.946766153702248
Andalucía,18,Granada,917297,748579,494171,489540,486116,3424,4631,C's,66000,13.482044368182375,1.0138859719771813,1.032315801545358
Andalucía,21,Huelva,520017,396117,249269,245819,243293,2526,3450,C's,28685,11.669154947339303,1.1059628648205073,0.8935034416033156
Andalucía,23,Jaén,654170,532211,375082,370762,368217,2545,4320,C's,38884,10.487590421887896,0.88078212057665906,0.8030314258719675
Andalucía,29,Málaga,1628973,1163657,752086,744858,738680,6178,7228,C's,121294,16.284177655338333,1.0551538057793985,1.246874246197422
Andalucía,41,Sevilla,1941480,1531806,1044851,1033112,1023530,9582,11739,C's,138086,13.366024206475194,0.9483770879627175,1.0234321750746702
Aragón,22,Huesca,222909,173546,118018,116884,115680,1204,1134,C's,17934,15.343417405290715,0.95453841968319,1.1748405363928571
Aragón,44,Teruel,138932,109380,75932,74922,74218,704,1010,C's,9871,13.175035370118257,0.9122801505207698,1.0088082212954255
Aragón,50,Zaragoza,956006,734064,517144,513135,509011,4124,4009,C's,86434,16.844300232882183,0.8815798597753839,1.2897626518286511
Principado de Asturias,33,Asturias,1051229,982837,600463,594699,589325,5374,5764,C's,74961,12.604863973203251,1.1606541982188268,0.9651503807965736
Illes Balears,7,Illes Balears,1104479,772939,469437,464787,460561,4226,4650,C's,67700,14.565811866510897,1.171419168730247,1.1152995303607118
Canarias,35,Las Palmas,1098406,842916,508957,502506,499004,3502,6451,C's,65172,12.969397380329786,1.1819656201767403,0.9930625865489882
Canarias,38,Santa Cruz de Tenerife,1001900,833373,481925,476666,473883,2783,5259,C's,52576,11.029945496427269,1.2581071785374423,0.844559379512042
Cantabria,39,Cantabria,585179,498203,341348,337567,335113,2454,3781,C's,48626,14.404844075398366,0.9392647389515052,1.1029742783612837
Castilla - La Mancha,2,Albacete,394580,310083,221706,219473,218043,1430,2233,C's,31976,14.569445899951248,0.8502708455678165,1.115577787132561
Castilla - La Mancha,13,Ciudad Real,513713,400552,282634,279396,277457,1939,3238,C's,33126,11.856289996993514,0.8782480415689832,0.9078323121740822
Castilla - La Mancha,16,Cuenca,203841,157835,117118,115849,115026,823,1269,C's,10868,9.38117722207356,0.7696060045183283,0.718313722976536
Castilla - La Mancha,19,Guadalajara,253686,182408,132903,131538,130716,822,1365,C's,21586,16.41046693731089,0.8096571833145115,1.256544175904356
Castilla - La Mancha,45,Toledo,693371,518206,371866,367503,365529,1974,4363,C's,47705,12.980846414859199,0.842474187866627,0.99393923544098
Castilla y León,5,Ávila,164925,139218,100106,98917,98200,717,1189,C's,14096,14.250331085657672,0.8381285291099745,1.0911432684270805
Castilla y León,9,Burgos,364002,300243,209246,206981,205169,1812,2265,C's,30361,14.668496142157975,0.9041701679078291,1.1231620323245004
Castilla y León,24,León,479395,440263,284076,280858,278461,2397,3218,C's,35870,12.771578520106248,1.0583484659042242,0.9779156600387632
Castilla y León,34,Palencia,166035,143769,101838,100626,99788,838,1212,C's,12428,12.350684713692287,0.8700935674605698,0.9456879566380005
Castilla y León,37,Salamanca,339395,308612,204615,202483,201040,1443,2132,C's,31878,15.743543902451071,1.0053192356495122,1.2054780936026854
Castilla y León,40,Segovia,157570,120823,89662,88525,87910,615,1137,C's,13595,15.357243716464275,0.7694098847172584,1.1758992125929766
Castilla y León,42,Soria,91006,76814,50337,49618,49018,600,719,C's,5679,11.445443185940587,1.0283107699701468,0.8763739039770739
Castilla y León,47,Valladolid,526288,433056,319280,315768,313534,2234,3512,C's,49283,15.60734463276836,0.7837951850043215,1.195049359323764
Castilla y León,49,Zamora,183436,173320,110339,108893,107883,1010,1446,C's,12423,11.408446823946443,1.0840688406176278,0.8735411044369404
Cataluña,8,Barcelona,5523922,4131319,2659818,2643933,2622852,21081,15885,C's,305075,11.538681199561411,1.0625951302898626,0.8835131086953607
Cataluña,17,Girona,753054,512366,310377,307853,305211,2642,2524,C's,23748,7.714071326249866,1.1760977155007135,0.5906639606623174
Cataluña,25,Lleida,436029,313207,182909,181159,179003,2156,1750,C's,12592,6.950800125856292,1.2410871524930254,0.5322205303105889
Cataluña,43,Tarragona,795101,562990,347861,344620,341560,3060,3241,C's,39082,11.340607045441356,1.139972218737824,0.8683466344135801
Extremadura,6,Badajoz,686730,558228,382981,377949,375230,2719,5032,C's,40417,10.693770852681181,0.9365586208921605,0.8188185951516984
Extremadura,10,Cáceres,406267,349082,239735,236205,234666,1539,3530,C's,24343,10.30587836836646,0.9344916107886598,0.7891177923710919
Galicia,15,A Coruña,1127196,1087472,651065,643389,636696,6693,7676,C's,60347,9.37955109583782,1.1972080117288424,0.7181892110136157
Galicia,27,Lugo,339386,348561,196272,192957,190869,2088,3315,C's,13343,6.915012152966724,1.3034240559407635,0.5294802567355837
Galicia,32,Ourense,318391,364469,188562,186177,184650,1527,2385,C's,13133,7.054039972714138,1.4398541976695018,0.5401255721833184
Galicia,36,Pontevedra,947374,901233,551762,544673,540255,4418,7089,C's,48302,8.868073137460458,1.1568313436579687,0.6790255082282127
Comunidad de Madrid,28,Madrid,6436996,4927932,3489376,3465795,3447658,18137,23581,C's,616503,17.788213093965453,0.8708794774093342,1.3620377560463592
Comunidad Foral de Navarra,31,Navarra,640476,502530,338720,335335,331867,3468,3385,C's,20505,6.114780741646413,0.9724659571019328,0.4682067949193272
País Vasco,1,Araba - Álava,323648,254579,169331,167640,166562,1078,1691,C's,8372,4.994034836554522,0.9989818840878956,0.38239164139008586
País Vasco,20,Gipuzkoa,716834,580706,367464,365493,362782,2711,1971,C's,11683,3.196504447417597,1.0955001058829656,0.24475531756643162
País Vasco,48,Bizkaia,1148775,948080,625444,621219,617312,3907,4225,C's,20685,3.3297436169853145,1.0152285669577845,0.2549573979314942
Región de Murcia,30,Murcia,1467288,1034075,719536,713592,709879,3713,5944,C's,111961,15.689777912308433,0.9074411158162694,1.2013612490282106
La Rioja,26,La Rioja,317053,247670,174913,172982,171757,1225,1931,C's,24180,13.978333005746263,0.8763899110111971,1.070316462920847
Comunitat Valenciana,3,Alicante / Alacant,1855047,1253296,882601,875169,870331,4838,7432,C's,138517,15.827457325385156,0.882386925972212,1.2119033174108083
Comunitat Valenciana,12,Castellón / Castelló,582327,416491,302324,299204,297135,2069,3120,C's,44121,14.746126388684644,0.8177695926626533,1.1291061553357307
Comunitat Valenciana,46,Valencia / València,2543315,1946046,1431843,1419521,1411013,8508,12322,C's,205489,14.475939419001199,0.7882745302115405,1.1084180259572127
Ciudad de Ceuta,51,Ceuta,84263,61587,31194,30837,30521,316,357,C's,3549,11.508901644128807,1.4722464326906544,0.8812328977127724
Ciudad de Melilla,52,Melilla,85584,57795,27483,27121,26853,268,362,C's,3352,12.359426274842374,1.564661203773274,0.9463572951640409
Andalucía,4,Almería,701211,491496,308989,306674,304461,2213,2315,ERC-CATSÍ,0,0,1.1077851234609697,0
Andalucía,11,Cádiz,1240284,993689,622252,615755,608817,6938,6497,ERC-CATSÍ,0,0,1.115143277818196,0
Andalucía,14,Córdoba,795611,651184,452038,446818,442329,4489,5220,ERC-CATSÍ,0,0,0.91235500030757255,0
Andalucía,18,Granada,917297,748579,494171,489540,486116,3424,4631,ERC-CATSÍ,0,0,1.0138859719771813,0
Andalucía,21,Huelva,520017,396117,249269,245819,243293,2526,3450,ERC-CATSÍ,0,0,1.1059628648205073,0
Andalucía,23,Jaén,654170,532211,375082,370762,368217,2545,4320,ERC-CATSÍ,0,0,0.88078212057665906,0
Andalucía,29,Málaga,1628973,1163657,752086,744858,738680,6178,7228,ERC-CATSÍ,0,0,1.0551538057793985,0
Andalucía,41,Sevilla,1941480,1531806,1044851,1033112,1023530,9582,11739,ERC-CATSÍ,0,0,0.9483770879627175,0
Aragón,22,Huesca,222909,173546,118018,116884,115680,1204,1134,ERC-CATSÍ,0,0,0.95453841968319,0
Aragón,44,Teruel,138932,109380,75932,74922,74218,704,1010,ERC-CATSÍ,0,0,0.9122801505207698,0
Aragón,50,Zaragoza,956006,734064,517144,513135,509011,4124,4009,ERC-CATSÍ,0,0,0.8815798597753839,0
Principado de Asturias,33,Asturias,1051229,982837,600463,594699,589325,5374,5764,ERC-CATSÍ,0,0,1.1606541982188268,0
Illes Balears,7,Illes Balears,1104479,772939,469437,464787,460561,4226,4650,ERC-CATSÍ,0,0,1.171419168730247,0
Canarias,35,Las Palmas,1098406,842916,508957,502506,499004,3502,6451,ERC-CATSÍ,0,0,1.1819656201767403,0
Canarias,38,Santa Cruz de Tenerife,1001900,833373,481925,476666,473883,2783,5259,ERC-CATSÍ,0,0,1.2581071785374423,0
Cantabria,39,Cantabria,585179,498203,341348,337567,335113,2454,3781,ERC-CATSÍ,0,0,0.9392647389515052,0
Castilla - La Mancha,2,Albacete,394580,310083,221706,219473,218043,1430,2233,ERC-CATSÍ,0,0,0.8502708455678165,0
Castilla - La Mancha,13,Ciudad Real,513713,400552,282634,279396,277457,1939,3238,ERC-CATSÍ,0,0,0.8782480415689832,0
Castilla - La Mancha,16,Cuenca,203841,157835,117118,115849,115026,823,1269,ERC-CATSÍ,0,0,0.7696060045183283,0
Castilla - La Mancha,19,Guadalajara,253686,182408,132903,131538,130716,822,1365,ERC-CATSÍ,0,0,0.8096571833145115,0
Castilla - La Mancha,45,Toledo,693371,518206,371866,367503,365529,1974,4363,ERC-CATSÍ,0,0,0.842474187866627,0
Castilla y León,5,Ávila,164925,139218,100106,98917,98200,717,1189,ERC-CATSÍ,0,0,0.8381285291099745,0
Castilla y León,9,Burgos,364002,300243,209246,206981,205169,1812,2265,ERC-CATSÍ,0,0,0.9041701679078291,0
Castilla y León,24,León,479395,440263,284076,280858,278461,2397,3218,ERC-CATSÍ,0,0,1.0583484659042242,0
Castilla y León,34,Palencia,166035,143769,101838,100626,99788,838,1212,ERC-CATSÍ,0,0,0.8700935674605698,0
Castilla y León,37,Salamanca,339395,308612,204615,202483,201040,1443,2132,ERC-CATSÍ,0,0,1.0053192356495122,0
Castilla y León,40,Segovia,157570,120823,89662,88525,87910,615,1137,ERC-CATSÍ,0,0,0.7694098847172584,0
Castilla y León,42,Soria,91006,76814,50337,49618,49018,600,719,ERC-CATSÍ,0,0,1.0283107699701468,0
Castilla y León,47,Valladolid,526288,433056,319280,315768,313534,2234,3512,ERC-CATSÍ,0,0,0.7837951850043215,0
Castilla y León,49,Zamora,183436,173320,110339,108893,107883,1010,1446,ERC-CATSÍ,0,0,1.0840688406176278,0
Cataluña,8,Barcelona,5523922,4131319,2659818,2643933,2622852,21081,15885,ERC-CATSÍ,438126,16.57099480206193,1.0625951302898626,6.300758479871456
Cataluña,17,Girona,753054,512366,310377,307853,305211,2642,2524,ERC-CATSÍ,80824,26.254088802123093,1.1760977155007135,9.982543270769238
Cataluña,25,Lleida,436029,313207,182909,181159,179003,2156,1750,ERC-CATSÍ,45525,25.129858301271256,1.2410871524930254,9.55507920200428
Cataluña,43,Tarragona,795101,562990,347861,344620,341560,3060,3241,ERC-CATSÍ,67759,19.661946491788058,1.139972218737824,7.476025282048692
Extremadura,6,Badajoz,686730,558228,382981,377949,375230,2719,5032,ERC-CATSÍ,0,0,0.9365586208921605,0
Extremadura,10,Cáceres,406267,349082,239735,236205,234666,1539,3530,ERC-CATSÍ,0,0,0.9344916107886598,0
Galicia,15,A Coruña,1127196,1087472,651065,643389,636696,6693,7676,ERC-CATSÍ,0,0,1.1972080117288424,0
Galicia,27,Lugo,339386,348561,196272,192957,190869,2088,3315,ERC-CATSÍ,0,0,1.3034240559407635,0
Galicia,32,Ourense,318391,364469,188562,186177,184650,1527,2385,ERC-CATSÍ,0,0,1.4398541976695018,0
Galicia,36,Pontevedra,947374,901233,551762,544673,540255,4418,7089,ERC-CATSÍ,0,0,1.1568313436579687,0
Comunidad de Madrid,28,Madrid,6436996,4927932,3489376,3465795,3447658,18137,23581,ERC-CATSÍ,0,0,0.8708794774093342,0
Comunidad Foral de Navarra,31,Navarra,640476,502530,338720,335335,331867,3468,3385,ERC-CATSÍ,0,0,0.9724659571019328,0
País Vasco,1,Araba - Álava,323648,254579,169331,167640,166562,1078,1691,ERC-CATSÍ,0,0,0.9989818840878956,0
País Vasco,20,Gipuzkoa,716834,580706,367464,365493,362782,2711,1971,ERC-CATSÍ,0,0,1.0955001058829656,0
País Vasco,48,Bizkaia,1148775,948080,625444,621219,617312,3907,4225,ERC-CATSÍ,0,0,1.0152285669577845,0
Región de Murcia,30,Murcia,1467288,1034075,719536,713592,709879,3713,5944,ERC-CATSÍ,0,0,0.9074411158162694,0
La Rioja,26,La Rioja,317053,247670,174913,172982,171757,1225,1931,ERC-CATSÍ,0,0,0.8763899110111971,0
Comunitat Valenciana,3,Alicante / Alacant,1855047,1253296,882601,875169,870331,4838,7432,ERC-CATSÍ,0,0,0.882386925972212,0
Comunitat Valenciana,12,Castellón / Castelló,582327,416491,302324,299204,297135,2069,3120,ERC-CATSÍ,0,0,0.8177695926626533,0
Comunitat Valenciana,46,Valencia / València,2543315,1946046,1431843,1419521,1411013,8508,12322,ERC-CATSÍ,0,0,0.7882745302115405,0
Ciudad de Ceuta,51,Ceuta,84263,61587,31194,30837,30521,316,357,ERC-CATSÍ,0,0,1.4722464326906544,0
Ciudad de Melilla,52,Melilla,85584,57795,27483,27121,26853,268,362,ERC-CATSÍ,0,0,1.564661203773274,0
Andalucía,4,Almería,701211,491496,308989,306674,304461,2213,2315,CDC,0,0,1.1077851234609697,0
Andalucía,11,Cádiz,1240284,993689,622252,615755,608817,6938,6497,CDC,0,0,1.115143277818196,0
Andalucía,14,Córdoba,795611,651184,452038,446818,442329,4489,5220,CDC,0,0,0.91235500030757255,0
Andalucía,18,Granada,917297,748579,494171,489540,486116,3424,4631,CDC,0,0,1.0138859719771813,0
Andalucía,21,Huelva,520017,396117,249269,245819,243293,2526,3450,CDC,0,0,1.1059628648205073,0
Andalucía,23,Jaén,654170,532211,375082,370762,368217,2545,4320,CDC,0,0,0.88078212057665906,0
Andalucía,29,Málaga,1628973,1163657,752086,744858,738680,6178,7228,CDC,0,0,1.0551538057793985,0
Andalucía,41,Sevilla,1941480,1531806,1044851,1033112,1023530,9582,11739,CDC,0,0,0.9483770879627175,0
Aragón,22,Huesca,222909,173546,118018,116884,115680,1204,1134,CDC,0,0,0.95453841968319,0
Aragón,44,Teruel,138932,109380,75932,74922,74218,704,1010,CDC,0,0,0.9122801505207698,0
Aragón,50,Zaragoza,956006,734064,517144,513135,509011,4124,4009,CDC,0,0,0.8815798597753839,0
Principado de Asturias,33,Asturias,1051229,982837,600463,594699,589325,5374,5764,CDC,0,0,1.1606541982188268,0
Illes Balears,7,Illes Balears,1104479,772939,469437,464787,460561,4226,4650,CDC,0,0,1.171419168730247,0
Canarias,35,Las Palmas,1098406,842916,508957,502506,499004,3502,6451,CDC,0,0,1.1819656201767403,0
Canarias,38,Santa Cruz de Tenerife,1001900,833373,481925,476666,473883,2783,5259,CDC,0,0,1.2581071785374423,0
Cantabria,39,Cantabria,585179,498203,341348,337567,335113,2454,3781,CDC,0,0,0.9392647389515052,0
Castilla - La Mancha,2,Albacete,394580,310083,221706,219473,218043,1430,2233,CDC,0,0,0.8502708455678165,0
Castilla - La Mancha,13,Ciudad Real,513713,400552,282634,279396,277457,1939,3238,CDC,0,0,0.8782480415689832,0
Castilla - La Mancha,16,Cuenca,203841,157835,117118,115849,115026,823,1269,CDC,0,0,0.7696060045183283,0
Castilla - La Mancha,19,Guadalajara,253686,182408,132903,131538,130716,822,1365,CDC,0,0,0.8096571833145115,0
Castilla - La Mancha,45,Toledo,693371,518206,371866,367503,365529,1974,4363,CDC,0,0,0.842474187866627,0
Castilla y León,5,Ávila,164925,139218,100106,98917,98200,717,1189,CDC,0,0,0.8381285291099745,0
Castilla y León,9,Burgos,364002,300243,209246,206981,205169,1812,2265,CDC,0,0,0.9041701679078291,0
Castilla y León,24,León,479395,440263,284076,280858,278461,2397,3218,CDC,0,0,1.0583484659042242,0
Castilla y León,34,Palencia,166035,143769,101838,100626,99788,838,1212,CDC,0,0,0.8700935674605698,0
Castilla y León,37,Salamanca,339395,308612,204615,202483,201040,1443,2132,CDC,0,0,1.0053192356495122,0
Castilla y León,40,Segovia,157570,120823,89662,88525,87910,615,1137,CDC,0,0,0.7694098847172584,0
Castilla y León,42,Soria,91006,76814,50337,49618,49018,600,719,CDC,0,0,1.0283107699701468,0
Castilla y León,47,Valladolid,526288,433056,319280,315768,313534,2234,3512,CDC,0,0,0.7837951850043215,0
Castilla y León,49,Zamora,183436,173320,110339,108893,107883,1010,1446,CDC,0,0,1.0840688406176278,0
Cataluña,8,Barcelona,5523922,4131319,2659818,2643933,2622852,21081,15885,CDC,323824,12.247814146576331,1.0625951302898626,6.093439873918573
Cataluña,17,Girona,753054,512366,310377,307853,305211,2642,2524,CDC,71453,23.210103523434885,1.1760977155007135,11.5473151857885
Cataluña,25,Lleida,436029,313207,182909,181159,179003,2156,1750,CDC,40985,22.62377248715217,1.2410871524930254,11.25560820256327
Cataluña,43,Tarragona,795101,562990,347861,344620,341560,3060,3241,CDC,47226,13.703789681388196,1.139972218737824,6.817805811635919
Extremadura,6,Badajoz,686730,558228,382981,377949,375230,2719,5032,CDC,0,0,0.9365586208921605,0
Extremadura,10,Cáceres,406267,349082,239735,236205,234666,1539,3530,CDC,0,0,0.9344916107886598,0
Galicia,15,A Coruña,1127196,1087472,651065,643389,636696,6693,7676,CDC,0,0,1.1972080117288424,0
Galicia,27,Lugo,339386,348561,196272,192957,190869,2088,3315,CDC,0,0,1.3034240559407635,0
Galicia,32,Ourense,318391,364469,188562,186177,184650,1527,2385,CDC,0,0,1.4398541976695018,0
Galicia,36,Pontevedra,947374,901233,551762,544673,540255,4418,7089,CDC,0,0,1.1568313436579687,0
Comunidad de Madrid,28,Madrid,6436996,4927932,3489376,3465795,3447658,18137,23581,CDC,0,0,0.8708794774093342,0
Comunidad Foral de Navarra,31,Navarra,640476,502530,338720,335335,331867,3468,3385,CDC,0,0,0.9724659571019328,0
País Vasco,1,Araba - Álava,323648,254579,169331,167640,166562,1078,1691,CDC,0,0,0.9989818840878956,0
País Vasco,20,Gipuzkoa,716834,580706,367464,365493,362782,2711,1971,CDC,0,0,1.0955001058829656,0
País Vasco,48,Bizkaia,1148775,948080,625444,621219,617312,3907,4225,CDC,0,0,1.0152285669577845,0
Región de Murcia,30,Murcia,1467288,1034075,719536,713592,709879,3713,5944,CDC,0,0,0.9074411158162694,0
La Rioja,26,La Rioja,317053,247670,174913,172982,171757,1225,1931,CDC,0,0,0.8763899110111971,0
Comunitat Valenciana,3,Alicante / Alacant,1855047,1253296,882601,875169,870331,4838,7432,CDC,0,0,0.882386925972212,0
Comunitat Valenciana,12,Castellón / Castelló,582327,416491,302324,299204,297135,2069,3120,CDC,0,0,0.8177695926626533,0
Comunitat Valenciana,46,Valencia / València,2543315,1946046,1431843,1419521,1411013,8508,12322,CDC,0,0,0.7882745302115405,0
Ciudad de Ceuta,51,Ceuta,84263,61587,31194,30837,30521,316,357,CDC,0,0,1.4722464326906544,0
Ciudad de Melilla,52,Melilla,85584,57795,27483,27121,26853,268,362,CDC,0,0,1.564661203773274,0
Andalucía,4,Almería,701211,491496,308989,306674,304461,2213,2315,EAJ-PNV,0,0,1.1077851234609697,0
Andalucía,11,Cádiz,1240284,993689,622252,615755,608817,6938,6497,EAJ-PNV,0,0,1.115143277818196,0
Andalucía,14,Córdoba,795611,651184,452038,446818,442329,4489,5220,EAJ-PNV,0,0,0.91235500030757255,0
Andalucía,18,Granada,917297,748579,494171,489540,486116,3424,4631,EAJ-PNV,0,0,1.0138859719771813,0
Andalucía,21,Huelva,520017,396117,249269,245819,243293,2526,3450,EAJ-PNV,0,0,1.1059628648205073,0
Andalucía,23,Jaén,654170,532211,375082,370762,368217,2545,4320,EAJ-PNV,0,0,0.88078212057665906,0
Andalucía,29,Málaga,1628973,1163657,752086,744858,738680,6178,7228,EAJ-PNV,0,0,1.0551538057793985,0
Andalucía,41,Sevilla,1941480,1531806,1044851,1033112,1023530,9582,11739,EAJ-PNV,0,0,0.9483770879627175,0
Aragón,22,Huesca,222909,173546,118018,116884,115680,1204,1134,EAJ-PNV,0,0,0.95453841968319,0
Aragón,44,Teruel,138932,109380,75932,74922,74218,704,1010,EAJ-PNV,0,0,0.9122801505207698,0
Aragón,50,Zaragoza,956006,734064,517144,513135,509011,4124,4009,EAJ-PNV,0,0,0.8815798597753839,0
Principado de Asturias,33,Asturias,1051229,982837,600463,594699,589325,5374,5764,EAJ-PNV,0,0,1.1606541982188268,0
Illes Balears,7,Illes Balears,1104479,772939,469437,464787,460561,4226,4650,EAJ-PNV,0,0,1.171419168730247,0
Canarias,35,Las Palmas,1098406,842916,508957,502506,499004,3502,6451,EAJ-PNV,0,0,1.1819656201767403,0
Canarias,38,Santa Cruz de Tenerife,1001900,833373,481925,476666,473883,2783,5259,EAJ-PNV,0,0,1.2581071785374423,0
Cantabria,39,Cantabria,585179,498203,341348,337567,335113,2454,3781,EAJ-PNV,0,0,0.9392647389515052,0
Castilla - La Mancha,2,Albacete,394580,310083,221706,219473,218043,1430,2233,EAJ-PNV,0,0,0.8502708455678165,0
Castilla - La Mancha,13,Ciudad Real,513713,400552,282634,279396,277457,1939,3238,EAJ-PNV,0,0,0.8782480415689832,0
Castilla - La Mancha,16,Cuenca,203841,157835,117118,115849,115026,823,1269,EAJ-PNV,0,0,0.7696060045183283,0
Castilla - La Mancha,19,Guadalajara,253686,182408,132903,131538,130716,822,1365,EAJ-PNV,0,0,0.8096571833145115,0
Castilla - La Mancha,45,Toledo,693371,518206,371866,367503,365529,1974,4363,EAJ-PNV,0,0,0.842474187866627,0
Castilla y León,5,Ávila,164925,139218,100106,98917,98200,717,1189,EAJ-PNV,0,0,0.8381285291099745,0
Castilla y León,9,Burgos,364002,300243,209246,206981,205169,1812,2265,EAJ-PNV,0,0,0.9041701679078291,0
Castilla y León,24,León,479395,440263,284076,280858,278461,2397,3218,EAJ-PNV,0,0,1.0583484659042242,0
Castilla y León,34,Palencia,166035,143769,101838,100626,99788,838,1212,EAJ-PNV,0,0,0.8700935674605698,0
Castilla y León,37,Salamanca,339395,308612,204615,202483,201040,1443,2132,EAJ-PNV,0,0,1.0053192356495122,0
Castilla y León,40,Segovia,157570,120823,89662,88525,87910,615,1137,EAJ-PNV,0,0,0.7694098847172584,0
Castilla y León,42,Soria,91006,76814,50337,49618,49018,600,719,EAJ-PNV,0,0,1.0283107699701468,0
Castilla y León,47,Valladolid,526288,433056,319280,315768,313534,2234,3512,EAJ-PNV,0,0,0.7837951850043215,0
Castilla y León,49,Zamora,183436,173320,110339,108893,107883,1010,1446,EAJ-PNV,0,0,1.0840688406176278,0
Cataluña,8,Barcelona,5523922,4131319,2659818,2643933,2622852,21081,15885,EAJ-PNV,0,0,1.0625951302898626,0
Cataluña,17,Girona,753054,512366,310377,307853,305211,2642,2524,EAJ-PNV,0,0,1.1760977155007135,0
Cataluña,25,Lleida,436029,313207,182909,181159,179003,2156,1750,EAJ-PNV,0,0,1.2410871524930254,0
Cataluña,43,Tarragona,795101,562990,347861,344620,341560,3060,3241,EAJ-PNV,0,0,1.139972218737824,0
Extremadura,6,Badajoz,686730,558228,382981,377949,375230,2719,5032,EAJ-PNV,0,0,0.9365586208921605,0
Extremadura,10,Cáceres,406267,349082,239735,236205,234666,1539,3530,EAJ-PNV,0,0,0.9344916107886598,0
Galicia,15,A Coruña,1127196,1087472,651065,643389,636696,6693,7676,EAJ-PNV,0,0,1.1972080117288424,0
Galicia,27,Lugo,339386,348561,196272,192957,190869,2088,3315,EAJ-PNV,0,0,1.3034240559407635,0
Galicia,32,Ourense,318391,364469,188562,186177,184650,1527,2385,EAJ-PNV,0,0,1.4398541976695018,0
Galicia,36,Pontevedra,947374,901233,551762,544673,540255,4418,7089,EAJ-PNV,0,0,1.1568313436579687,0
Comunidad de Madrid,28,Madrid,6436996,4927932,3489376,3465795,3447658,18137,23581,EAJ-PNV,0,0,0.8708794774093342,0
Comunidad Foral de Navarra,31,Navarra,640476,502530,338720,335335,331867,3468,3385,EAJ-PNV,0,0,0.9724659571019328,0
País Vasco,1,Araba - Álava,323648,254579,169331,167640,166562,1078,1691,EAJ-PNV,26703,15.928775948460988,0.9989818840878956,13.385526007110075
País Vasco,20,Gipuzkoa,716834,580706,367464,365493,362782,2711,1971,EAJ-PNV,85015,23.260363399572633,1.0955001058829656,19.546523865187087
País Vasco,48,Bizkaia,1148775,948080,625444,621219,617312,3907,4225,EAJ-PNV,175296,28.218068024319926,1.0152285669577845,23.712662205310863
Región de Murcia,30,Murcia,1467288,1034075,719536,713592,709879,3713,5944,EAJ-PNV,0,0,0.9074411158162694,0
La Rioja,26,La Rioja,317053,247670,174913,172982,171757,1225,1931,EAJ-PNV,0,0,0.8763899110111971,0
Comunitat Valenciana,3,Alicante / Alacant,1855047,1253296,882601,875169,870331,4838,7432,EAJ-PNV,0,0,0.882386925972212,0
Comunitat Valenciana,12,Castellón / Castelló,582327,416491,302324,299204,297135,2069,3120,EAJ-PNV,0,0,0.8177695926626533,0
Comunitat Valenciana,46,Valencia / València,2543315,1946046,1431843,1419521,1411013,8508,12322,EAJ-PNV,0,0,0.7882745302115405,0
Ciudad de Ceuta,51,Ceuta,84263,61587,31194,30837,30521,316,357,EAJ-PNV,0,0,1.4722464326906544,0
Ciudad de Melilla,52,Melilla,85584,57795,27483,27121,26853,268,362,EAJ-PNV,0,0,1.564661203773274,0
Andalucía,4,Almería,701211,491496,308989,306674,304461,2213,2315,EH.Bildu,0,0,1.1077851234609697,0
Andalucía,11,Cádiz,1240284,993689,622252,615755,608817,6938,6497,EH.Bildu,0,0,1.115143277818196,0
Andalucía,14,Córdoba,795611,651184,452038,446818,442329,4489,5220,EH.Bildu,0,0,0.91235500030757255,0
Andalucía,18,Granada,917297,748579,494171,489540,486116,3424,4631,EH.Bildu,0,0,1.0138859719771813,0
Andalucía,21,Huelva,520017,396117,249269,245819,243293,2526,3450,EH.Bildu,0,0,1.1059628648205073,0
Andalucía,23,Jaén,654170,532211,375082,370762,368217,2545,4320,EH.Bildu,0,0,0.88078212057665906,0
Andalucía,29,Málaga,1628973,1163657,752086,744858,738680,6178,7228,EH.Bildu,0,0,1.0551538057793985,0
Andalucía,41,Sevilla,1941480,1531806,1044851,1033112,1023530,9582,11739,EH.Bildu,0,0,0.9483770879627175,0
Aragón,22,Huesca,222909,173546,118018,116884,115680,1204,1134,EH.Bildu,0,0,0.95453841968319,0
Aragón,44,Teruel,138932,109380,75932,74922,74218,704,1010,EH.Bildu,0,0,0.9122801505207698,0
Aragón,50,Zaragoza,956006,734064,517144,513135,509011,4124,4009,EH.Bildu,0,0,0.8815798597753839,0
Principado de Asturias,33,Asturias,1051229,982837,600463,594699,589325,5374,5764,EH.Bildu,0,0,1.1606541982188268,0
Illes Balears,7,Illes Balears,1104479,772939,469437,464787,460561,4226,4650,EH.Bildu,0,0,1.171419168730247,0
Canarias,35,Las Palmas,1098406,842916,508957,502506,499004,3502,6451,EH.Bildu,0,0,1.1819656201767403,0
Canarias,38,Santa Cruz de Tenerife,1001900,833373,481925,476666,473883,2783,5259,EH.Bildu,0,0,1.2581071785374423,0
Cantabria,39,Cantabria,585179,498203,341348,337567,335113,2454,3781,EH.Bildu,0,0,0.9392647389515052,0
Castilla - La Mancha,2,Albacete,394580,310083,221706,219473,218043,1430,2233,EH.Bildu,0,0,0.8502708455678165,0
Castilla - La Mancha,13,Ciudad Real,513713,400552,282634,279396,277457,1939,3238,EH.Bildu,0,0,0.8782480415689832,0
Castilla - La Mancha,16,Cuenca,203841,157835,117118,115849,115026,823,1269,EH.Bildu,0,0,0.7696060045183283,0
Castilla - La Mancha,19,Guadalajara,253686,182408,132903,131538,130716,822,1365,EH.Bildu,0,0,0.8096571833145115,0
Castilla - La Mancha,45,Toledo,693371,518206,371866,367503,365529,1974,4363,EH.Bildu,0,0,0.842474187866627,0
Castilla y León,5,Ávila,164925,139218,100106,98917,98200,717,1189,EH.Bildu,0,0,0.8381285291099745,0
Castilla y León,9,Burgos,364002,300243,209246,206981,205169,1812,2265,EH.Bildu,0,0,0.9041701679078291,0
Castilla y León,24,León,479395,440263,284076,280858,278461,2397,3218,EH.Bildu,0,0,1.0583484659042242,0
Castilla y León,34,Palencia,166035,143769,101838,100626,99788,838,1212,EH.Bildu,0,0,0.8700935674605698,0
Castilla y León,37,Salamanca,339395,308612,204615,202483,201040,1443,2132,EH.Bildu,0,0,1.0053192356495122,0
Castilla y León,40,Segovia,157570,120823,89662,88525,87910,615,1137,EH.Bildu,0,0,0.7694098847172584,0
Castilla y León,42,Soria,91006,76814,50337,49618,49018,600,719,EH.Bildu,0,0,1.0283107699701468,0
Castilla y León,47,Valladolid,526288,433056,319280,315768,313534,2234,3512,EH.Bildu,0,0,0.7837951850043215,0
Castilla y León,49,Zamora,183436,173320,110339,108893,107883,1010,1446,EH.Bildu,0,0,1.0840688406176278,0
Cataluña,8,Barcelona,5523922,4131319,2659818,2643933,2622852,21081,15885,EH.Bildu,0,0,1.0625951302898626,0
Cataluña,17,Girona,753054,512366,310377,307853,305211,2642,2524,EH.Bildu,0,0,1.1760977155007135,0
Cataluña,25,Lleida,436029,313207,182909,181159,179003,2156,1750,EH.Bildu,0,0,1.2410871524930254,0
Cataluña,43,Tarragona,795101,562990,347861,344620,341560,3060,3241,EH.Bildu,0,0,1.139972218737824,0
Extremadura,6,Badajoz,686730,558228,382981,377949,375230,2719,5032,EH.Bildu,0,0,0.9365586208921605,0
Extremadura,10,Cáceres,406267,349082,239735,236205,234666,1539,3530,EH.Bildu,0,0,0.9344916107886598,0
Galicia,15,A Coruña,1127196,1087472,651065,643389,636696,6693,7676,EH.Bildu,0,0,1.1972080117288424,0
Galicia,27,Lugo,339386,348561,196272,192957,190869,2088,3315,EH.Bildu,0,0,1.3034240559407635,0
Galicia,32,Ourense,318391,364469,188562,186177,184650,1527,2385,EH.Bildu,0,0,1.4398541976695018,0
Galicia,36,Pontevedra,947374,901233,551762,544673,540255,4418,7089,EH.Bildu,0,0,1.1568313436579687,0
Comunidad de Madrid,28,Madrid,6436996,4927932,3489376,3465795,3447658,18137,23581,EH.Bildu,0,0,0.8708794774093342,0
Comunidad Foral de Navarra,31,Navarra,640476,502530,338720,335335,331867,3468,3385,EH.Bildu,31374,9.356017117211147,0.9724659571019328,12.150671580793697
País Vasco,1,Araba - Álava,323648,254579,169331,167640,166562,1078,1691,EH.Bildu,15858,9.459556191839656,0.9989818840878956,12.285137911480073
País Vasco,20,Gipuzkoa,716834,580706,367464,365493,362782,2711,1971,EH.Bildu,69828,19.105153860675856,1.0955001058829656,24.811888130747864
País Vasco,48,Bizkaia,1148775,948080,625444,621219,617312,3907,4225,EH.Bildu,67653,10.890362335987792,1.0152285669577845,14.143327709075054
Región de Murcia,30,Murcia,1467288,1034075,719536,713592,709879,3713,5944,EH.Bildu,0,0,0.9074411158162694,0
La Rioja,26,La Rioja,317053,247670,174913,172982,171757,1225,1931,EH.Bildu,0,0,0.8763899110111971,0
Comunitat Valenciana,3,Alicante / Alacant,1855047,1253296,882601,875169,870331,4838,7432,EH.Bildu,0,0,0.882386925972212,0
Comunitat Valenciana,12,Castellón / Castelló,582327,416491,302324,299204,297135,2069,3120,EH.Bildu,0,0,0.8177695926626533,0
Comunitat Valenciana,46,Valencia / València,2543315,1946046,1431843,1419521,1411013,8508,12322,EH.Bildu,0,0,0.7882745302115405,0
Ciudad de Ceuta,51,Ceuta,84263,61587,31194,30837,30521,316,357,EH.Bildu,0,0,1.4722464326906544,0
Ciudad de Melilla,52,Melilla,85584,57795,27483,27121,26853,268,362,EH.Bildu,0,0,1.564661203773274,0
Andalucía,4,Almería,701211,491496,308989,306674,304461,2213,2315,CCa-PNC,0,0,1.1077851234609697,0
Andalucía,11,Cádiz,1240284,993689,622252,615755,608817,6938,6497,CCa-PNC,0,0,1.115143277818196,0
Andalucía,14,Córdoba,795611,651184,452038,446818,442329,4489,5220,CCa-PNC,0,0,0.91235500030757255,0
Andalucía,18,Granada,917297,748579,494171,489540,486116,3424,4631,CCa-PNC,0,0,1.0138859719771813,0
Andalucía,21,Huelva,520017,396117,249269,245819,243293,2526,3450,CCa-PNC,0,0,1.1059628648205073,0
Andalucía,23,Jaén,654170,532211,375082,370762,368217,2545,4320,CCa-PNC,0,0,0.88078212057665906,0
Andalucía,29,Málaga,1628973,1163657,752086,744858,738680,6178,7228,CCa-PNC,0,0,1.0551538057793985,0
Andalucía,41,Sevilla,1941480,1531806,1044851,1033112,1023530,9582,11739,CCa-PNC,0,0,0.9483770879627175,0
Aragón,22,Huesca,222909,173546,118018,116884,115680,1204,1134,CCa-PNC,0,0,0.95453841968319,0
Aragón,44,Teruel,138932,109380,75932,74922,74218,704,1010,CCa-PNC,0,0,0.9122801505207698,0
Aragón,50,Zaragoza,956006,734064,517144,513135,509011,4124,4009,CCa-PNC,0,0,0.8815798597753839,0
Principado de Asturias,33,Asturias,1051229,982837,600463,594699,589325,5374,5764,CCa-PNC,0,0,1.1606541982188268,0
Illes Balears,7,Illes Balears,1104479,772939,469437,464787,460561,4226,4650,CCa-PNC,0,0,1.171419168730247,0
Canarias,35,Las Palmas,1098406,842916,508957,502506,499004,3502,6451,CCa-PNC,17982,3.5784647347494354,1.1819656201767403,10.843832529543743
Canarias,38,Santa Cruz de Tenerife,1001900,833373,481925,476666,473883,2783,5259,CCa-PNC,60271,12.644283418578208,1.2581071785374423,38.316010359327905
Cantabria,39,Cantabria,585179,498203,341348,337567,335113,2454,3781,CCa-PNC,0,0,0.9392647389515052,0
Castilla - La Mancha,2,Albacete,394580,310083,221706,219473,218043,1430,2233,CCa-PNC,0,0,0.8502708455678165,0
Castilla - La Mancha,13,Ciudad Real,513713,400552,282634,279396,277457,1939,3238,CCa-PNC,0,0,0.8782480415689832,0
Castilla - La Mancha,16,Cuenca,203841,157835,117118,115849,115026,823,1269,CCa-PNC,0,0,0.7696060045183283,0
Castilla - La Mancha,19,Guadalajara,253686,182408,132903,131538,130716,822,1365,CCa-PNC,0,0,0.8096571833145115,0
Castilla - La Mancha,45,Toledo,693371,518206,371866,367503,365529,1974,4363,CCa-PNC,0,0,0.842474187866627,0
Castilla y León,5,Ávila,164925,139218,100106,98917,98200,717,1189,CCa-PNC,0,0,0.8381285291099745,0
Castilla y León,9,Burgos,364002,300243,209246,206981,205169,1812,2265,CCa-PNC,0,0,0.9041701679078291,0
Castilla y León,24,León,479395,440263,284076,280858,278461,2397,3218,CCa-PNC,0,0,1.0583484659042242,0
Castilla y León,34,Palencia,166035,143769,101838,100626,99788,838,1212,CCa-PNC,0,0,0.8700935674605698,0
Castilla y León,37,Salamanca,339395,308612,204615,202483,201040,1443,2132,CCa-PNC,0,0,1.0053192356495122,0
Castilla y León,40,Segovia,157570,120823,89662,88525,87910,615,1137,CCa-PNC,0,0,0.7694098847172584,0
Castilla y León,42,Soria,91006,76814,50337,49618,49018,600,719,CCa-PNC,0,0,1.0283107699701468,0
Castilla y León,47,Valladolid,526288,433056,319280,315768,313534,2234,3512,CCa-PNC,0,0,0.7837951850043215,0
Castilla y León,49,Zamora,183436,173320,110339,108893,107883,1010,1446,CCa-PNC,0,0,1.0840688406176278,0
Cataluña,8,Barcelona,5523922,4131319,2659818,2643933,2622852,21081,15885,CCa-PNC,0,0,1.0625951302898626,0
Cataluña,17,Girona,753054,512366,310377,307853,305211,2642,2524,CCa-PNC,0,0,1.1760977155007135,0
Cataluña,25,Lleida,436029,313207,182909,181159,179003,2156,1750,CCa-PNC,0,0,1.2410871524930254,0
Cataluña,43,Tarragona,795101,562990,347861,344620,341560,3060,3241,CCa-PNC,0,0,1.139972218737824,0
Extremadura,6,Badajoz,686730,558228,382981,377949,375230,2719,5032,CCa-PNC,0,0,0.9365586208921605,0
Extremadura,10,Cáceres,406267,349082,239735,236205,234666,1539,3530,CCa-PNC,0,0,0.9344916107886598,0
Galicia,15,A Coruña,1127196,1087472,651065,643389,636696,6693,7676,CCa-PNC,0,0,1.1972080117288424,0
Galicia,27,Lugo,339386,348561,196272,192957,190869,2088,3315,CCa-PNC,0,0,1.3034240559407635,0
Galicia,32,Ourense,318391,364469,188562,186177,184650,1527,2385,CCa-PNC,0,0,1.4398541976695018,0
Galicia,36,Pontevedra,947374,901233,551762,544673,540255,4418,7089,CCa-PNC,0,0,1.1568313436579687,0
Comunidad de Madrid,28,Madrid,6436996,4927932,3489376,3465795,3447658,18137,23581,CCa-PNC,0,0,0.8708794774093342,0
Comunidad Foral de Navarra,31,Navarra,640476,502530,338720,335335,331867,3468,3385,CCa-PNC,0,0,0.9724659571019328,0
País Vasco,1,Araba - Álava,323648,254579,169331,167640,166562,1078,1691,CCa-PNC,0,0,0.9989818840878956,0
País Vasco,20,Gipuzkoa,716834,580706,367464,365493,362782,2711,1971,CCa-PNC,0,0,1.0955001058829656,0
País Vasco,48,Bizkaia,1148775,948080,625444,621219,617312,3907,4225,CCa-PNC,0,0,1.0152285669577845,0
Región de Murcia,30,Murcia,1467288,1034075,719536,713592,709879,3713,5944,CCa-PNC,0,0,0.9074411158162694,0
La Rioja,26,La Rioja,317053,247670,174913,172982,171757,1225,1931,CCa-PNC,0,0,0.8763899110111971,0
Comunitat Valenciana,3,Alicante / Alacant,1855047,1253296,882601,875169,870331,4838,7432,CCa-PNC,0,0,0.882386925972212,0
Comunitat Valenciana,12,Castellón / Castelló,582327,416491,302324,299204,297135,2069,3120,CCa-PNC,0,0,0.8177695926626533,0
Comunitat Valenciana,46,Valencia / València,2543315,1946046,1431843,1419521,1411013,8508,12322,CCa-PNC,0,0,0.7882745302115405,0
Ciudad de Ceuta,51,Ceuta,84263,61587,31194,30837,30521,316,357,CCa-PNC,0,0,1.4722464326906544,0
Ciudad de Melilla,52,Melilla,85584,57795,27483,27121,26853,268,362,CCa-PNC,0,0,1.564661203773274,0
Andalucía,4,Almería,701211,491496,308989,306674,304461,2213,2315,VOX,435,0.14184443415483544,1.1077851234609697,1.19745653748483
Andalucía,11,Cádiz,1240284,993689,622252,615755,608817,6938,6497,VOX,1253,0.20349002444153924,1.115143277818196,1.0293697026712954
Andalucía,14,Córdoba,795611,651184,452038,446818,442329,4489,5220,VOX,708,0.15845377760072332,0.91235500030757255,1.0101292055690698
Andalucía,18,Granada,917297,748579,494171,489540,486116,3424,4631,VOX,993,0.2028434857212894,1.0138859719771813,1.0538940763082474
Andalucía,21,Huelva,520017,396117,249269,245819,243293,2526,3450,VOX,398,0.16190774512954653,1.1059628648205073,1.011121724571941
Andalucía,23,Jaén,654170,532211,375082,370762,368217,2545,4320,VOX,638,0.17207804467556007,0.88078212057665906,0.9968099198537008
Andalucía,29,Málaga,1628973,1163657,752086,744858,738680,6178,7228,VOX,1770,0.2376291856971396,1.0551538057793985,1.0791866345740895
Andalucía,41,Sevilla,1941480,1531806,1044851,1033112,1023530,9582,11739,VOX,2146,0.2077219120482581,0.9483770879627175,0.9380596030744229
Aragón,22,Huesca,222909,173546,118018,116884,115680,1204,1134,VOX,399,0.3413640874713391,0.95453841968319,1.0832534292623972
Aragón,44,Teruel,138932,109380,75932,74922,74218,704,1010,VOX,0,0,0.9122801505207698,1.1350614740821001
Aragón,50,Zaragoza,956006,734064,517144,513135,509011,4124,4009,VOX,1614,0.31453711011722063,0.8815798597753839,1.0700688165971466
Principado de Asturias,33,Asturias,1051229,982837,600463,594699,589325,5374,5764,VOX,1442,0.24247560530621373,1.1606541982188268,1.0667318076074825
Illes Balears,7,Illes Balears,1104479,772939,469437,464787,460561,4226,4650,VOX,0,0,1.171419168730247,1.088874306816259
Canarias,35,Las Palmas,1098406,842916,508957,502506,499004,3502,6451,VOX,882,0.17552029229501737,1.1819656201767403,1.0463145374106289
Canarias,38,Santa Cruz de Tenerife,1001900,833373,481925,476666,473883,2783,5259,VOX,0,0,1.2581071785374423,1.0247818475567787
Cantabria,39,Cantabria,585179,498203,341348,337567,335113,2454,3781,VOX,713,0.2112173287080787,0.9392647389515052,1.15940507974147
Castilla - La Mancha,2,Albacete,394580,310083,221706,219473,218043,1430,2233,VOX,0,0,0.8502708455678165,1.1363168590873725
Castilla - La Mancha,13,Ciudad Real,513713,400552,282634,279396,277457,1939,3238,VOX,0,0,0.8782480415689832,1.1505969501964375
Castilla - La Mancha,16,Cuenca,203841,157835,117118,115849,115026,823,1269,VOX,274,0.23651477354142028,0.7696060045183283,1.1407221377204542
Castilla - La Mancha,19,Guadalajara,253686,182408,132903,131538,130716,822,1365,VOX,541,0.4112879928233666,0.8096571833145115,1.1317681453695938
Castilla - La Mancha,45,Toledo,693371,518206,371866,367503,365529,1974,4363,VOX,1013,0.27564400834823116,0.842474187866627,1.1573612784471048
Castilla y León,5,Ávila,164925,139218,100106,98917,98200,717,1189,VOX,0,0,0.8381285291099745,1.3078409082575453
Castilla y León,9,Burgos,364002,300243,209246,206981,205169,1812,2265,VOX,647,0.3125890782245713,0.9041701679078291,1.1794593937465085
Castilla y León,24,León,479395,440263,284076,280858,278461,2397,3218,VOX,620,0.22075212384906254,1.0583484659042242,1.1324662141444215
Castilla y León,34,Palencia,166035,143769,101838,100626,99788,838,1212,VOX,0,0,0.8700935674605698,1.1920262456532407
Castilla y León,37,Salamanca,339395,308612,204615,202483,201040,1443,2132,VOX,0,0,1.0053192356495122,1.2966935303899183
Castilla y León,40,Segovia,157570,120823,89662,88525,87910,615,1137,VOX,277,0.3129059587687094,0.7694098847172584,1.2091561084834823
Castilla y León,42,Soria,91006,76814,50337,49618,49018,600,719,VOX,119,0.23983231891652224,1.0283107699701468,1.1907099241125887
Castilla y León,47,Valladolid,526288,433056,319280,315768,313534,2234,3512,VOX,1078,0.3413898811785868,0.7837951850043215,1.153784940335513
Castilla y León,49,Zamora,183436,173320,110339,108893,107883,1010,1446,VOX,0,0,1.0840688406176278,1.2556132555958113
Cataluña,8,Barcelona,5523922,4131319,2659818,2643933,2622852,21081,15885,VOX,0,0,1.0625951302898626,0.6364573426719531
Cataluña,17,Girona,753054,512366,310377,307853,305211,2642,2524,VOX,0,0,1.1760977155007135,0.5153829256885782
Cataluña,25,Lleida,436029,313207,182909,181159,179003,2156,1750,VOX,198,0.10929625356730828,1.2410871524930254,0.5758828055879629
Cataluña,43,Tarragona,795101,562990,347861,344620,341560,3060,3241,VOX,0,0,1.139972218737824,0.6597562531397942
Extremadura,6,Badajoz,686730,558228,382981,377949,375230,2719,5032,VOX,617,0.16324953895896008,0.9365586208921605,1.0777950127224025
Extremadura,10,Cáceres,406267,349082,239735,236205,234666,1539,3530,VOX,409,0.1731546749645435,0.9344916107886598,1.0873015600466265
Galicia,15,A Coruña,1127196,1087472,651065,643389,636696,6693,7676,VOX,1026,0.1594680667527732,1.1972080117288424,1.1099340356777185
Galicia,27,Lugo,339386,348561,196272,192957,190869,2088,3315,VOX,0,0,1.3034240559407635,1.2165303764977122
Galicia,32,Ourense,318391,364469,188562,186177,184650,1527,2385,VOX,0,0,1.4398541976695018,1.277242684535405
Galicia,36,Pontevedra,947374,901233,551762,544673,540255,4418,7089,VOX,0,0,1.1568313436579687,1.0695726031375337
Comunidad de Madrid,28,Madrid,6436996,4927932,3489376,3465795,3447658,18137,23581,VOX,16803,0.48482382829913484,0.8708794774093342,1.1373495312677178
Comunidad Foral de Navarra,31,Navarra,640476,502530,338720,335335,331867,3468,3385,VOX,0,0,0.9724659571019328,0.8866813567238485
País Vasco,1,Araba - Álava,323648,254579,169331,167640,166562,1078,1691,VOX,306,0.18253400143163923,0.9989818840878956,0.6697837482561817
País Vasco,20,Gipuzkoa,716834,580706,367464,365493,362782,2711,1971,VOX,0,0,1.0955001058829656,0.4568880157666715
País Vasco,48,Bizkaia,1148775,948080,625444,621219,617312,3907,4225,VOX,641,0.10318422327713736,1.0152285669577845,0.5023942941564379
Región de Murcia,30,Murcia,1467288,1034075,719536,713592,709879,3713,5944,VOX,2622,0.36743685467325865,0.9074411158162694,1.2552695698339877
La Rioja,26,La Rioja,317053,247670,174913,172982,171757,1225,1931,VOX,366,0.2115827080274248,0.8763899110111971,1.1623385648637543
Comunitat Valenciana,3,Alicante / Alacant,1855047,1253296,882601,875169,870331,4838,7432,VOX,2003,0.2288700810929089,0.882386925972212,1.1053649856058612
Comunitat Valenciana,12,Castellón / Castelló,582327,416491,302324,299204,297135,2069,3120,VOX,711,0.23763051296105667,0.8177695926626533,1.0494412208780766
Comunitat Valenciana,46,Valencia / València,2543315,1946046,1431843,1419521,1411013,8508,12322,VOX,3381,0.2381789350069495,0.7882745302115405,1.0153621291777783
Ciudad de Ceuta,51,Ceuta,84263,61587,31194,30837,30521,316,357,VOX,139,0.4507572072510296,1.4722464326906544,1.3725641121903425
Ciudad de Melilla,52,Melilla,85584,57795,27483,27121,26853,268,362,VOX,0,0,1.564661203773274,1.3631836861634747
Andalucía,4,Almería,701211,491496,308989,306674,304461,2213,2315,UP,40578,13.231640112953821,1.1077851234609697,0.6270919484812237
Andalucía,11,Cádiz,1240284,993689,622252,615755,608817,6938,6497,UP,130643,21.21671768804151,1.115143277818196,1.0055316439830098
Andalucía,14,Córdoba,795611,651184,452038,446818,442329,4489,5220,UP,85058,19.036386179607803,0.91235500030757255,0.9021983971378105
Andalucía,18,Granada,917297,748579,494171,489540,486116,3424,4631,UP,86975,17.76667892307064,1.0138859719771813,0.8420226977758596
Andalucía,21,Huelva,520017,396117,249269,245819,243293,2526,3450,UP,40023,16.281491666632768,1.1059628648205073,0.771634676143733
Andalucía,23,Jaén,654170,532211,375082,370762,368217,2545,4320,UP,53239,14.359346427087996,0.88078212057665906,0.6805377453596206
Andalucía,29,Málaga,1628973,1163657,752086,744858,738680,6178,7228,UP,140829,18.906825193526817,1.0551538057793985,0.8960580660439249
Andalucía,41,Sevilla,1941480,1531806,1044851,1033112,1023530,9582,11739,UP,214663,20.778289285188826,0.9483770879627175,0.9847530466914135
Aragón,22,Huesca,222909,173546,118018,116884,115680,1204,1134,UP,22430,19.18996612025598,0.95453841968319,0.90947706731071
Aragón,44,Teruel,138932,109380,75932,74922,74218,704,1010,UP,12558,16.761431889164733,0.9122801505207698,0.7943806582542526
Aragón,50,Zaragoza,956006,734064,517144,513135,509011,4124,4009,UP,104199,20.306352129556547,0.8815798597753839,0.9623863568510211
Principado de Asturias,33,Asturias,1051229,982837,600463,594699,589325,5374,5764,UP,141845,23.851561882565804,1.1606541982188268,1.1304057764249196
Illes Balears,7,Illes Balears,1104479,772939,469437,464787,460561,4226,4650,UP,118082,25.4056159057805,1.171419168730247,1.2040576258663744
Canarias,35,Las Palmas,1098406,842916,508957,502506,499004,3502,6451,UP,113256,22.53823834939284,1.1819656201767403,1.068162954947528
Canarias,38,Santa Cruz de Tenerife,1001900,833373,481925,476666,473883,2783,5259,UP,85178,17.869535481867807,1.2581071785374423,0.8468974162022657
Cantabria,39,Cantabria,585179,498203,341348,337567,335113,2454,3781,UP,59845,17.728332449558163,0.9392647389515052,0.840205329362946
Castilla - La Mancha,2,Albacete,394580,310083,221706,219473,218043,1430,2233,UP,33509,15.267937286135425,0.8502708455678165,0.7235989235135272
Castilla - La Mancha,13,Ciudad Real,513713,400552,282634,279396,277457,1939,3238,UP,37510,13.425389053529758,0.8782480415689832,0.6362743627265287
Castilla - La Mancha,16,Cuenca,203841,157835,117118,115849,115026,823,1269,UP,15263,13.174908717382108,0.7696060045183283,0.6244032567479672
Castilla - La Mancha,19,Guadalajara,253686,182408,132903,131538,130716,822,1365,UP,23884,18.157490611078167,0.8096571833145115,0.8605445787240836
Castilla - La Mancha,45,Toledo,693371,518206,371866,367503,365529,1974,4363,UP,53994,14.692124962245206,0.842474187866627,0.6963092399168344
Castilla y León,5,Ávila,164925,139218,100106,98917,98200,717,1189,UP,12527,12.66415277454836,0.8381285291099745,0.6001968139596379
Castilla y León,9,Burgos,364002,300243,209246,206981,205169,1812,2265,UP,35705,17.250375638343616,0.9041701679078291,0.817553347788797
Castilla y León,24,León,479395,440263,284076,280858,278461,2397,3218,UP,49484,17.618867897656468,1.0583484659042242,0.8350174359078895
Castilla y León,34,Palencia,166035,143769,101838,100626,99788,838,1212,UP,15077,14.98320513584958,0.8700935674605698,0.7101045088080369
Castilla y León,37,Salamanca,339395,308612,204615,202483,201040,1443,2132,UP,25441,12.564511588627195,1.0053192356495122,0.5954744828733267
Castilla y León,40,Segovia,157570,120823,89662,88525,87910,615,1137,UP,13440,15.182151934481785,0.7694098847172584,0.7195332670370514
Castilla y León,42,Soria,91006,76814,50337,49618,49018,600,719,UP,7599,15.315006650812204,1.0283107699701468,0.7258296990906258
Castilla y León,47,Valladolid,526288,433056,319280,315768,313534,2234,3512,UP,51637,16.35282865901548,0.7837951850043215,0.7750155762566577
Castilla y León,49,Zamora,183436,173320,110339,108893,107883,1010,1446,UP,15403,14.145078196027294,1.0840688406176278,0.6703828528922887
Cataluña,8,Barcelona,5523922,4131319,2659818,2643933,2622852,21081,15885,UP,694315,26.260688149056726,1.0625951302898626,1.2445823767325461
Cataluña,17,Girona,753054,512366,310377,307853,305211,2642,2524,UP,53277,17.305986948316242,1.1760977155007135,0.8201889548965043
Cataluña,25,Lleida,436029,313207,182909,181159,179003,2156,1750,UP,30182,16.660502652366155,1.2410871524930254,0.7895972821026613
Cataluña,43,Tarragona,795101,562990,347861,344620,341560,3060,3241,UP,75328,21.85827868376763,1.139972218737824,1.0359373783776127
Extremadura,6,Badajoz,686730,558228,382981,377949,375230,2719,5032,UP,47182,12.483694890051304,0.9365586208921605,0.5916443075853698
Extremadura,10,Cáceres,406267,349082,239735,236205,234666,1539,3530,UP,33164,14.04034630934993,0.9344916107886598,0.6654192563672953
Galicia,15,A Coruña,1127196,1087472,651065,643389,636696,6693,7676,UP,148566,23.091162578160336,1.1972080117288424,1.0943678946995419
Galicia,27,Lugo,339386,348561,196272,192957,190869,2088,3315,UP,32752,16.97372989837114,1.3034240559407635,0.804442175278253
Galicia,32,Ourense,318391,364469,188562,186177,184650,1527,2385,UP,29136,15.64962374514575,1.4398541976695018,0.741688329153827
Galicia,36,Pontevedra,947374,901233,551762,544673,540255,4418,7089,UP,137088,25.168862785561245,1.1568313436579687,1.1928370988417651
Comunidad de Madrid,28,Madrid,6436996,4927932,3489376,3465795,3447658,18137,23581,UP,737885,21.29049756260829,0.8708794774093342,1.0090283205027626
Comunidad Foral de Navarra,31,Navarra,640476,502530,338720,335335,331867,3468,3385,UP,94972,28.321529217051605,0.9724659571019328,1.342252569528512
País Vasco,1,Araba - Álava,323648,254579,169331,167640,166562,1078,1691,UP,51827,30.91565258888094,0.9989818840878956,1.465196805160234
País Vasco,20,Gipuzkoa,716834,580706,367464,365493,362782,2711,1971,UP,104566,28.609576653998847,1.0955001058829656,1.3559041068245898
País Vasco,48,Bizkaia,1148775,948080,625444,621219,617312,3907,4225,UP,179347,28.870172998572162,1.0152285669577845,1.3682546444820929
Región de Murcia,30,Murcia,1467288,1034075,719536,713592,709879,3713,5944,UP,103522,14.507169362885234,0.9074411158162694,0.687543571700722
La Rioja,26,La Rioja,317053,247670,174913,172982,171757,1225,1931,UP,28772,16.632944468210564,0.8763899110111971,0.7882912070241973
Comunitat Valenciana,3,Alicante / Alacant,1855047,1253296,882601,875169,870331,4838,7432,UP,193263,22.08293483887112,0.882386925972212,1.0465845895199584
Comunitat Valenciana,12,Castellón / Castelló,582327,416491,302324,299204,297135,2069,3120,UP,72281,24.15776527051777,0.8177695926626533,1.1449177853325958
Comunitat Valenciana,46,Valencia / València,2543315,1946046,1431843,1419521,1411013,8508,12322,UP,394227,27.771832892926557,0.7882745302115405,1.3162006110391733
Ciudad de Ceuta,51,Ceuta,84263,61587,31194,30837,30521,316,357,UP,3345,10.847358692479814,1.4722464326906544,0.5140928290274793
Ciudad de Melilla,52,Melilla,85584,57795,27483,27121,26853,268,362,UP,2667,9.83370819660042,1.564661203773274,0.4660525211658966
